niveau Test
true
7
63
16
0 0 0 0 1 1 1 1 2 2 2 2 0 0 0 0 1 1 1 1 2 2 2 2 3 3 3 3 0 0 0 0 1 1 1 1 0 3 1 0 3 0 0 3 1 0 3 1 0 3 0 0 3 1 0 3 1 0 3 0 0 3 1
0 3 1 0 3 0 0 3 1 0 3 1 0 3 0 0 3 1 0 3 1 0 3 0 0 3 1 0 3 1 0 3 0 0 3 1 0 3 1 0 3 0 0 3 1 0 3 1 0 3 0 0 3 1 0 3 1 0 3 0 0 3 1
0 3 1 0 3 0 0 3 1 0 3 1 0 3 0 0 3 1 0 3 1 0 3 0 0 3 1 0 3 1 0 3 0 0 3 1 0 3 1 0 3 0 0 3 1 0 3 1 0 3 0 0 3 1 0 3 1 0 3 0 0 3 1
0 3 1 0 3 0 0 3 1 0 3 1 0 3 0 0 3 1 0 3 1 0 3 0 0 3 1 0 3 1 0 3 0 0 3 1 0 3 1 0 3 0 0 3 1 0 3 1 0 3 0 0 3 1 0 3 1 0 3 0 0 3 1
0 3 1 0 2 2 2 2 2 2 2 2 2 2 2 2 2 2 0 3 1 0 3 0 0 3 1 0 3 1 0 3 0 0 3 1 0 3 1 0 3 0 0 3 1 0 3 1 0 3 0 0 3 1 0 3 1 0 3 0 0 3 1
0 3 1 0 3 0 0 3 1 0 3 1 0 3 0 0 3 1 0 3 1 0 3 0 0 3 1 0 3 1 0 1 1 1 1 1 0 3 1 0 3 0 0 3 1 0 3 1 0 3 0 0 3 1 0 3 1 0 3 0 0 3 1
0 3 1 0 3 0 0 3 1 0 3 1 0 3 0 0 3 1 0 3 1 0 3 0 0 3 1 0 3 1 0 3 0 0 3 1 0 3 1 0 3 0 0 3 1 0 3 1 0 3 0 0 3 1 0 3 1 0 3 0 0 3 1
0 3 1 0 3 0 0 3 1 0 3 1 0 3 0 0 3 1 0 3 1 0 3 0 0 3 1 0 3 1 0 3 0 0 3 1 0 3 1 0 3 0 0 3 1 0 3 1 0 3 0 0 3 1 0 3 1 0 3 0 0 3 1
0 3 1 0 3 0 0 3 1 0 3 1 0 3 0 0 3 1 0 3 1 0 3 0 0 3 1 0 3 1 0 3 0 0 3 1 0 3 1 0 3 0 0 3 1 0 3 1 0 3 0 0 3 1 0 3 1 0 3 0 0 3 1
0 3 1 0 3 0 0 3 1 0 3 1 0 3 0 0 3 1 0 3 1 0 3 0 0 3 1 0 3 1 0 3 0 0 3 1 0 3 1 0 3 0 0 3 1 0 3 1 0 3 0 0 3 1 0 3 1 0 3 0 0 3 1
0 3 1 0 3 0 0 3 1 0 3 1 0 3 0 0 3 1 0 3 1 0 3 0 0 3 1 0 3 1 0 3 0 0 3 1 0 3 1 0 3 0 0 3 1 0 3 1 0 3 0 0 3 1 0 3 1 0 3 0 0 3 1
0 3 1 0 3 0 0 3 1 0 3 1 0 3 0 0 3 1 0 3 1 0 3 0 0 3 1 0 3 1 0 3 0 0 3 1 0 3 1 0 3 0 0 3 1 0 3 1 0 3 0 0 3 1 0 3 1 0 3 0 0 3 1
0 3 1 0 3 0 0 3 1 0 3 1 0 3 0 0 3 1 0 3 1 0 3 0 0 3 1 0 3 1 0 3 0 0 3 1 0 3 1 0 3 0 0 3 1 0 3 1 0 3 0 0 3 1 0 3 1 0 3 0 0 3 1
0 3 1 0 3 0 0 3 1 0 3 1 0 3 0 0 3 1 0 3 1 0 3 0 0 3 1 0 3 1 0 3 0 0 3 1 0 3 1 0 3 0 0 3 1 0 3 1 0 3 0 0 3 1 0 3 1 0 3 0 0 3 1
0 3 1 0 3 0 0 3 1 0 3 1 0 3 0 0 3 1 0 3 1 0 3 0 0 3 1 0 3 1 0 3 0 0 3 1 0 3 1 0 3 0 0 3 1 0 3 1 0 3 0 0 3 1 0 3 1 0 3 0 0 3 1
0 3 1 0 3 0 0 3 1 0 3 1 0 3 0 0 3 1 0 3 1 0 3 0 0 3 1 0 3 1 0 3 0 0 3 1 0 3 1 0 3 0 0 3 1 0 3 1 0 3 0 0 3 1 0 3 1 0 3 0 0 3 1